 ■ ■ ■ ■ ■ ■ ■ ■ ■ ■ ■ ■ ■ ■ ■ ■ ■ ■ ■ ■ ■ ■ ■ ■ ■ ■ ■ ■ ■ ■ ■ ■ ■ ■ ■ ■ ■ ■ ■ ■ ■ ■ ■ ■ ■ ■ ■ ■ ■ ■
 ■ * * * * * *   * * + * * * * * * * * * * * * * + * * * * *   * * * + * * * * * * * * * * * * * * ■
 ■ * *           * * + * * * * * * * * * * * * * +             * * * + * * * * * * * * * * * * * * ■
 ■ * *           * * + * *   * * * * * * * * * * +             * * * + * * *   * * * * * * * * * * ■
 ■ * *           * * +                     * * * +             * * * +                         * * ■
 ■ * *           * * +                     * * * +             * * * +                         * * ■
 ■ * *           * * +                     * * * +             * * * +                         * * ■
 ■ * *           * * +                     * * * +             * * * +                         * * ■
 ■ * *                                     * * * +             * * * +                         * * ■
 ■ * *           * * + * * * * * * * * * * * * * +             * * * +                         * * ■
 ■ * * * * * * * * * + * * * * * * * * * * * * * + * * * * * * * * * + * * * * * * * * * * * * * * ■
 ■ * * * * * * * * * + + + + + + + + + + + + + + + * * * * * * * * * + * * * * * * * * * * * * * * ■
 ■ * * * * * * * * * + *                     * * + + + + + + + + + + + + + + + + + + + + + + + + + +
 ■ + + + + + + + + + + *                     * * + *             * * + * * * * * * * * * * * * * * ■
 ■ *             * * + *                     * * + *                   * * * * * * * * * * * * * * ■
 ■ *             * * + *                     * * + *             * * +                       * * * ■
 ■ *             * * + *                     * * + *             * * +                       * * * ■
 ■ *             * * + *                                         * * +                       * * * ■
 ■ *             * * + *                     * * + *             * * +                       * * * ■
 ■ *             * * + *                     * * + *             * * +                       * * * ■
 ■ *             * * + *                     * * + *             * * +                       * * * ■
 ■ *             * * + *                     * * + *             * * +                       * * * ■
 ■ *             * * + *                     * * + *             * * + * * * * *   * * * * * * * * ■
 ■ *             * * + *                     * * + *   * * * * * * * + * * * * *   * * * * * * * * ■
 ■ * * * * * * * * * + * * * * * * * * * *   * * + +   + + + + + + + + + + + + +   + + + + + + + + +
 ■ * * * * * * * * * + * * * * * * * * * *   * * + * *             * + * * * * *   * * * * * * * * ■
 ■ + + + + + + + + + + + + + + + + + + + +   + + + * *             * + * * * * *   * * * * * * * * ■
 ■ * * * * * * * * *   * + * * * * * * * *   * * + * *             * + *                       * * ■
 ■                     * + * * * * * * * *   * * + * *             * + *                       * * ■
 ■ *                   * + *                 * * + * *             * + *                       * * ■
 ■ *                   * + *                 * * + * *             * + *                       * * ■
 ■ *                   * + *                 * * + * *             * + *                       * * ■
 ■ *                   * + *                 * * + * * * * *   * * * + *                       * * ■
 ■ *                   * + *                 * * + * * * * *   * * * + * * * * * * * * * * * * * * ■
 ■ * * * * * * * * * * * + *                 * * + + + + + +   + + + + + + + + + + + + + + + + + + +
 ■ * * * * * * * * * * * + * * * * * * * * * * * + * * * * *   * * * + * * * * * * * * * * * * * * ■
 ■ * * * * * * * * * * * + + + + + + + + + + + + +               * * + * * * * * * * * * * * * * * ■
 ■ + + + + + + + + + + + + * * * * * * * * * * * +                                           * * * ■
 ■ * * * * * * * * * * * + * * * * * * * * * * * +               * * + * *                   * * * ■
 ■ * *                                     * * * +               * * + * *                   * * * ■
 ■ * *                 * +                 * * * +               * * + * *                   * * * ■
 ■ * *                 * +                 * * * +               * * + * *                   * * * ■
 ■ * *                 * +                 * * * +               * * + * *                   * * * ■
 ■ * *                 * +                 * * * +               * * + * *                   * * * ■
 ■ * *                 * +                 * * * +               * * + * *                   * * * ■
 ■ * *                 * +                 * * * +               * * + * *                   * * * ■
 ■ * *                                                           * * + * * * * * * * * * * * * * * ■
 ■ * * * * * * * * * * * + * * * * * * * * * * * +               * * + * * * * * * * * * * * * * * ■
 ■ * * * * * * * * * * * + * * * * * * * * * * * + * * * * * * * * * + * * * * * * * * * * * * * * ■
 ■ ■ ■ ■ ■ ■ ■ ■ ■ ■ ■ ■ + ■ ■ ■ ■ ■ ■ ■ ■ ■ ■ ■ + ■ ■ ■ ■ ■ ■ ■ ■ ■ + ■ ■ ■ ■ ■ ■ ■ ■ ■ ■ ■ ■ ■ ■ ■
