 ■ ■ ■ ■ ■ ■ ■ ■ ■ ■ ■ ■ ■ ■ ■ ■ ■ ■ ■ ■ ■ ■ ■ ■ ■ ■ ■ ■ ■ ■ ■ ■ ■ ■ ■ ■ ■ ■ ■ ■ ■ ■ ■ ■ ■ ■ ■ ■ ■ ■
 ■ * * * * * * * * * * + * * * * * * * * * * * * * + * * * * * * * * * * * + * * * * * * * * * * * ■
 ■ * * * * * * * * * * + *                       * + *                 * * + * *                 * ■
 ■ * * * * * * * * * * + *                       * + *                 * * + * *                 * ■
 ■ *                 * + *                       * + *                 * * + * *                 * ■
 ■ *                 * + *                       * + *                 * * + * *                 * ■
 ■ *                 * + *                       * + *                 * * + * *                 * ■
 ■ *                 * + * * * * * * * * * *   * * + *                 * * + * *                 * ■
 ■ *                 * + * * * * * * * * * *   * * + *                                           * ■
 ■ *                 * + * * * * * * * * * *   * * + *                 * * + * *                 * ■
 ■ * *   * * * * * * * + + + + + + + + + + +   + + + *                 * * + * * * * * * * * *   * ■
 ■ + +   + + + + + + + + * * * * * * * * * *   * * + *   * * * * *   * * * + + + + + + + + + +   + +
 ■ *             * * * + * * * * * * * * * *   * * + *   * * * * *   * * * + * * * * * * * * *   * ■
 ■ *             * * * + *                     * * + +   + + + + +   + + + + * * * * * * * * *   * ■
 ■ *             * * * + *                     * * + *   * * * * *   * * * +                 *   * ■
 ■ *                                           * * + *   * * * * *   * * * +                 *   * ■
 ■ *             * * * + *                     * * + *                 * * +                 *   * ■
 ■ *             * * * + *                     * * + *                 * * +                 *   * ■
 ■ *             * * * + *                     * * + *                 * * +                 *   * ■
 ■ *             * * * + *                     * * + *                 * * +                 *   * ■
 ■ *             * * * + * * * * *   * * * * * * * + *                 * * +                 *   * ■
 ■ *             * * * + * * * * *   * * * * * * * + *                                       *   * ■
 ■ * * * * * * * * * * + * * * * *   * * * * * * * + *                 * * +                 *   * ■
 ■ + + + + + + + + + + + + + + + +   + + + + + + + + *                 * * +                 *   * ■
 ■ *               * * * + * * * *   * * * * * * * + *   * * * * * * * * * + * * * * * * * * *   * ■
 ■ *               * * * + *                 * * * + +   + + + + + + + + + + + + + + + + + + +   + +
 ■ *               * * * + *                 * * * + *   * * * * * * * * + * * * * * * * * * *   * ■
 ■ *               * * * + *                 * * * + *   * * * * * * * * + *                     * ■
 ■ *               * * * + *                 * * * + *                 * + *                     * ■
 ■ *               * * * + *                 * * * + *                 * + *                     * ■
 ■ *               * * * + *                 * * * + *                 * + *                     * ■
 ■ *                                         * * * + *                 * + *                     * ■
 ■ *               * * * + *                 * * * + *                 * + *                     * ■
 ■ *               * * * + * *   * * * * * * * * * + *                 * + * * * * * * * * * * * * ■
 ■ *               * * * + + +   + + + + + + + + + + *   * * * * * * * * + * * * * * * * * * * * * ■
 ■ *               * * * + * *               * * * + *   * * * * * * * * + + + + + + + + + + + + + +
 ■ * * * * * * * * * * * + * *               * * * + *   * * * * * * * * + *                 * * * ■
 ■ + + + + + + + + + + + + * *               * * * + +   + + + + + + + + + *                 * * * ■
 ■ *               * * * + * *               * * * + *   * * * * * * * * + *                 * * * ■
 ■ *               * * * + * *               * * * + *   * * * * * * * * + *                 * * * ■
 ■ *               * * * + * *               * * * + *             * * * + *                 * * * ■
 ■ *               * * * + * *               * * * + *             * * * + *                 * * * ■
 ■ *               * * * + * *               * * * + *             * * * + *                 * * * ■
 ■ *               * * * + * *               * * * + *             * * * + *                 * * * ■
 ■ *               * * * + * *               * * * + *             * * * + *                 * * * ■
 ■ *               * * * + * *                                                               * * * ■
 ■ * * * * * * * * * * * + * *               * * * + *             * * * + *                 * * * ■
 ■ * * * * * * * * * * * + * * * * * * * * * * * * + * * * * * * * * * * + * * * * * * * * * * * * ■
 ■ * * * * * * * * * * * + * * * * * * * * * * * * + * * * * * * * * * * + * * * * * * * * * * * * ■
 ■ ■ ■ ■ ■ ■ ■ ■ ■ ■ ■ ■ + ■ ■ ■ ■ ■ ■ ■ ■ ■ ■ ■ ■ + ■ ■ ■ ■ ■ ■ ■ ■ ■ ■ + ■ ■ ■ ■ ■ ■ ■ ■ ■ ■ ■ ■ ■
