 ■ ■ ■ ■ ■ ■ ■ ■ ■ ■ ■ ■ ■ ■ ■ ■ ■ ■ ■ ■ ■ ■ ■ ■ ■ ■ ■ ■ ■ ■ ■ ■ ■ ■ ■ ■ ■ ■ ■ ■ ■ ■ ■ ■ ■ ■ ■ ■ ■ ■
 ■ * * * * * * * * * * * * + * * * * * * * * * * * + * * * * * * * * * * * + * * * * * * * * * * * ■
 ■ * * *               * * + * * * * * * * * * * * +                   * * +                     * ■
 ■ * * *               * * + * * * * * * * * * * * +                   * * +                     * ■
 ■ * * *               * * + * *             * * * +                                             * ■
 ■ * * *               * * + * *             * * * +                   * * +                     * ■
 ■ * * *               * * + * *             * * * +                   * * +                     * ■
 ■ * * *               * * + * *             * * * +                   * * +                     * ■
 ■ * * *               * * + * *             * * * +                   * * +                     * ■
 ■ * * *               * * + * *             * * * +                   * * +                     * ■
 ■ * * * * * * * *   * * * + * *             * * * + * * * *   * * * * * * + * *   * * * * * * * * ■
 ■ * * * * * * * *   * * * + * *   * * * * * * * * + * * * *   * * * * * * + + +   + + + + + + + + +
 ■ + + + + + + + +   + + + + + +   + + + + + + + + + * * * *   * * * * * * + * *   * * * * * * * * ■
 ■ * * * * * * * *   * * * + * *   * * * * * * * * + + + + +   + + + + + + +                     * ■
 ■ *                   * * +                 * * * + * *               * * +                     * ■
 ■ *                   * * +                 * * * + * *               * * +                     * ■
 ■ *                                         * * * + * *               * * +                     * ■
 ■ *                   * * +                 * * * + * *               * * +                     * ■
 ■ *                   * * +                 * * * + * *               * * +                     * ■
 ■ *                   * * +                                           * * +                     * ■
 ■ *                   * * +                 * * * + * *               * * +                     * ■
 ■ *                   * * +                 * * * + * * * * *   * * * * * + * * * * * * * * * * * ■
 ■ *                   * * +                 * * * + * * * * *   * * * * * + * * * * * * * * * * * ■
 ■ * * * * *   * * * * * * + * * * * * * * * * * * + * * * * *   * * * * * + * * * * * * * * * * * ■
 ■ + + + + +   + + + + + + + + + + + + + + + + + + + + + + + +   + + + + + + + + + + + + + + + + + +
 ■ * * * * *   * * * * * * * + *               * * + * * * * *   * * * * * + *                 * * ■
 ■ * * *                 * * + *               * * +                   * * + *                 * * ■
 ■ * * *                 * * + *               * * +                   * * + *                 * * ■
 ■ * * *                                       * * +                   * * + *                 * * ■
 ■ * * *                 * * + *               * * +                   * * + *                 * * ■
 ■ * * *                 * * + *               * * +                   * * + *                 * * ■
 ■ * * *                 * * + *               * * +                   * * + *                 * * ■
 ■ * * *                 * * + *               * * +                   * * + *                 * * ■
 ■ * * *                 * * + *               * * + * * * * * *   * * * * + *                 * * ■
 ■ * * * * * * *   * * * * * + * * * *   * * * * * + * * * * * *   * * * * + *                 * * ■
 ■ * * * * * * *   * * * * * + * * * *   * * * * * + * * * * * *   * * * * + * * *   * * * * * * * ■
 ■ + + + + + + +   + + + + + + * * * *   * * * * * + + + + + + +   + + + + + + + +   + + + + + + + +
 ■ * * * * * * *   * * * * * + + + + +   + + + + + + * * * * * *   * * * * + * *             * * * ■
 ■ *                   * * * + * * * *   * * * * * + *                 * * + * *             * * * ■
 ■ *                   * * * + * * * *   * * * * * + *                                       * * * ■
 ■ *                   * * * + * *           * * * + *                 * * + * *             * * * ■
 ■ *                   * * * + * *           * * * + *                 * * + * *             * * * ■
 ■ *                   * * * + * *           * * * + *                 * * + * *             * * * ■
 ■ *                   * * * + * *           * * * + *                 * * + * *             * * * ■
 ■ *                   * * * + * *           * * * + *                 * * + * *             * * * ■
 ■ *                   * * * + * *           * * * + *                 * * + * *             * * * ■
 ■ *                   * * * + * *           * * * + *                 * * + * *             * * * ■
 ■ *                   * * * + * *           * * * + * * * * * * * * * * * + * *             * * * ■
 ■ * * * * * * * * * * * * * + * * * * * * * * * * + * * * * * * * * * * * + * * * * * * * * * * * ■
 ■ ■ ■ ■ ■ ■ ■ ■ ■ ■ ■ ■ ■ ■ + ■ ■ ■ ■ ■ ■ ■ ■ ■ ■ + ■ ■ ■ ■ ■ ■ ■ ■ ■ ■ ■ + ■ ■ ■ ■ ■ ■ ■ ■ ■ ■ ■ ■
